1111111111111
10C1000000CE1
1000C1C110001
1P00110C00001
1111111111111
