111111111111111111111111111111111111
111000000000C00000000000000000C000E1
1000011P0110000000111111100000000001
10000111111000C0000C0011000000000001
1000000001100000000110C0000000000001
100000000110000000111111100000000001
1000000001100000000110C00000000000C1
110000000110000000111111100000000011
1C0000000000C00000000000000000000C11
111111111111111111111111111111111111
